- - - - - - - - - - - - - -
- - - - - - - - - - - - - -
- - - - - - - - - - - - - -
- - - - - - - - - - - - - -
- - - - - - - - - - - - - -
- - - - C C C C C C - - - -
- - - - - - - - - - - - - -
- - - - - - B B - - - - - -
- - - - - B B B B - - - - -
C - - - B B - - B B - - - -
- - - B B - - - - B B - - -
- - B B - F F F F - B B - -
B B B B B B B B B B B B B B