- - - - - - - -
- - - - - - - -
- - - - - - - -
- - - - - - - -
- - - - - - - -
- - C - C C - -
- - C - C C C C
- C C C C C C C
C C C C B C C C
C C B C C B C C
C B C C C C B C
B C C C C C C B
B B B B B B B B